awit	awit	C_PNG
sulat	sulat	C_PNG
pagkain	pagkain	C_PNG
lakad	lakad	C_PNG
doktor	doktor	C_PNG
estudyante	estudyante	C_PNG
lalaki	lalaki	C_PNG
babae	babae	C_PNG
bahay	bahay	C_PNG
hangin	hangin	C_PNG
tanghali	tanghali	C_PNG
umaga	umaga	C_PNG
ala-1	1	C_PNG
alas-2	2	C_PNG
alas-3	3	C_PNG
alas-4	4	C_PNG
alas-5	5	C_PNG
alas-6	6	C_PNG
alas-7	7	C_PNG
alas-8	8	C_PNG
alas-9	9	C_PNG
alas-10	10	C_PNG
alas-11	11	C_PNG
alas-12	12	C_PNG
ala-una	una	C_PNG
alas-dos	dos	C_PNG
alas-tres	tres	C_PNG
alas-kwatro	kwatro	C_PNG
alas-singko	singko	C_PNG
alas-sais	sais	C_PNG
alas-syete	syete	C_PNG
alas-otso	otso	C_PNG
alas-nwebe	nwebe	C_PNG
alas-dyes	dyes	C_PNG
alas-onse	onse	C_PNG
alas-dose	dose	C_PNG
tulog	tulog	C_PNG
magnanakaw	nakaw	C_PNG
0	0	C_PNG
1	1	C_PNG
2	2	C_PNG
3	3	C_PNG
4	4	C_PNG
5	5	C_PNG
6	6	C_PNG
7	7	C_PNG
8	8	C_PNG
9	9	C_PNG
10	10	C_PNG
11	11	C_PNG
12	12	C_PNG
13	13	C_PNG
14	14	C_PNG
15	15	C_PNG
16	16	C_PNG
17	17	C_PNG
18	18	C_PNG
19	19	C_PNG
20	20	C_PNG
21	21	C_PNG
22	22	C_PNG
23	23	C_PNG
24	24	C_PNG
25	25	C_PNG
26	26	C_PNG
27	27	C_PNG
28	28	C_PNG
29	29	C_PNG
30	30	C_PNG
31	31	C_PNG
Juan	Juan	P_PNG
Jose	Jose	P_PNG
Simoun	Simoun	P_PNG
Maria	Maria	P_PNG
Stephen	Stephen	P_PNG
Justin	Justin	P_PNG
Zhean	Zhean	P_PNG
Hep	Hep	P_PNG
Aaron	Aaron	P_PNG
James	James	P_PNG
Nathaniel	Nathaniel	P_PNG
takbo	takbo	PND
tumakbo	takbo	PND
tumatakbo	takbo	PND
awit	awit	PND
umawit	awit	PND
umaawit	awit	PND
sulat	sulat	PND
sumulat	sulat	PND
sumusulat	sulat	PND
kain	kain	PND
kumain	kain	PND
kumakain	kain	PND
lakad	lakad	PND
naglakad	lakad	PND
naglalakad	lakad	PND
punta	punta	PND
pumunta	punta	PND
pumupunta	punta	PND
nakaw	nakaw	PND
nagnakaw	nakaw	PND
nagnanakaw	nakaw	PND
ayaw	ayaw	PAB
baka	baka	PAB
bukas	bukas	PAB
gaano	gaano	PAB
hindi	hindi	PAB
maayos	ayos	PAB
halos	halos	PAB
higit	higit	PAB
hindi	hindi	PAB
kahapon	hapon	PAB
kanina	kanina	PAB
lalo	lalo	PAB
lubha	lubha	PAB
mabigat	bigat	PAB
mabilis	bilis	PAB
mabuti	buti	PAB
mabuting	buti	PAB
madalas	dalas	PAB
madali	dali	PAB
madaling	dali	PAB
magalang	galang	PAB
magaling	galing	PAB
maaraw	araw	PAB
mahina	hina	PAB
tulog	tulog	PU
maayos	ayos	PU
mabagal	bagal	PU
mataas	taas	PU
mababa	baba	PU
maliit	liit	PU
malaki	laki	PU
mainit	init	PU
malamig	lamig	PU
maingay	ingay	PU
mabait	bait	PU
mahina	hina	PU
malakas	lakas	PU
basa	basa	PU
sikat	sikat	PU
matamis	tamis	PU
maalat	alat	PU
maanghang	anghang	PU
mapait	pait	PU
maaraw	araw	PU
maulan	ulan	PU
mahangin	hangin	PU
makulimlim	kulimlim	PU
masaya	saya	PU
malungkot	lungkot	PU
galit	galit	PU
gulat	gulat	PU
takot	takot	PU
simple	simple	PU
payat	payat	PU
mataba	taba	PU
kalbo	kalbo	PU
madaldal	daldal	PU
tahimik	tahimik	PU
masipag	sipag	PU
mabigat	bigat	PU
mabilis	bilis	PU
ako	ako	PH
ako	ako	BN
akong	ako	PH
ikaw	ikaw	PH
ka	ka	PH
kami	kami	PH
kaming	kami	PH
kang	ka	PH
kayo	kayo	PH
kayong	kayo	PH
sila	sila	PH
silang	sila	PH
siya	siya	PH
siyang	siya	PH
tayo	tayo	PH
tayong	tayo	PH
ko	ko	PH
kong	ko	PH
mo	mo	PH
mong	mo	PH
namin	namin	PH
naming	namin	PH
natin	natin	PH
nating	natin	PH
nila	nila	PH
nilang	nila	PH
ninyo	ninyo	PH
ninyong	ninyo	PH
niya	niya	PH
niyang	niya	PH
akin	akin	PH
aking	akin	PH
amin	amin	PH
aming	amin	PH
atin	atin	PH
ating	atin	PH
inyo	inyo	PH
inyong	inyo	PH
iyo	iyo	PH
iyong	iyo	PH
kanila	kanila	PH
kanilang	kanila	PH
kaniya	kaniya	PH
kaniyang	kaniya	PH
ito	ito	PH
itong	ito	PH
iyan	iyan	PH
iyang	iyan	PH
iyun	iyun	PH
iyung	iyun	PH
nito	nito	PH
nitong	nito	PH
nyan	nyan	PH
nyang	nyan	PH
dito	dito	PH
ditong	dito	PH
diyan	diyan	PH
diyang	diyan	PH
doon	doon	PH
doong	doon	PH
dyan	dyan	PH
dyang	dyan	PH
nang	nang	PUG
dahil	dahil	PUG
at	at	PUG
datapwat	datapwat	PUG
kahit	kahit	PUG
kapag	kapag	PUG
kaya	kaya	PUG
kung	kung	PUG
ngunit	ngunit	PUG
para	para	PUG
pati	pati	PUG
saka	saka	PUG
sakali	sakali	PUG
samantala	samantala	PUG
sapagkat	sapagkat	PUG
subalit	subalit	PUG
upang	upang	PUG
adlaw	adlaw	BN
ayam	ayam	BN
balay	balay	BN
bola	bola	BN
bulan	bulan	BN
kakanon	kakan	BN
lamesa	lamesa	BN
libro	libro	BN
polís	polís	BN
pusa	pusa	BN
sarong	sarong	BN
sira	sira	BN
tawo	tawo	BN
tubig	tubig	BN
lakaw	lakaw	BRB
tukdo	tukdo	BRB
magtukdo	tukdo	BRB
nagtukdo	tukdo	BRB
itinukdo	tukdo	BRB
tinukdo’án 	tukdo	BRB